0qedgapfkfqr6nw1yh67wydugtkvq5wu	r p s 	p r r 
12r25tpee4mzv2fuabqli828xzbbeiwe	s p s r s p r r r r s p s r p s r p s r p s p p s p r s p p p s p p 	r r p s p s r s p s p s s p r p r r p p r s s s r r s s s r s s p s 
16s0hzlqw71pcsf39hderfn0no10uu1q	s p r s r s s p s r p s r 	p s r r r r p r r p r s r 
1nlweighb7q6sricbnscccc3077l86mn	p p p p p p p p p p p p p p p p p p p p p p r p s p s r p s r p s s s s s p p p p p p p p p p p p p p p r s r s p r s p s r p r p p s p r p s p r s 	r s p r p s s p s s p r r r s r r r r p s p p p r p r p s r r s s r p r s r p s p r s r s s s p p p p s p r p p p p s s p s s p p s p s s r s p p p 
1otrg8efkhgony9qsuh47n1azlxlamjl	p s s p p r s p p r r r r s s p s s r p p r s p p p p r r r r r r r r r r r r r s s p s s r s p s p r r s s r p p p p r r s s r p p s p r p p p p s r p s p p r r r p s s p r s p r r p p p p p p p p r s s r p s r p p s p s p r p p p p p s s p p r r r s s p s r r r p p s s r r p p p p p p p p p p p p p p p p p p p r r r s p r p s p p p r r p s s p s r p p s p r s p p r r r s s s p p r p p p s s p r s s p s s s r p s p p r r r r r s s s s s s p r r r p p p s p p r r s p r p p s s p r r r r r r p r r r s p r r r r p r r r s p p r r r r s p p r r r r r s s s p p p p p r r s p s r p p r p p s p r p p s p s s 	p r s r r p s s r s s p s r p r s p r s r s p s s p r p p r r p r r r p r s s s s p p r r r s p s s s p s r r s r p r r s p r r p p s p r p r s r p r r p s r p r s p p p r r p r p s s s p s p s r r s p s s r s r r s p s r s p p s r p r r p s r r p p r s p r p s r s p r p s p r r s s s p s r p s s s p s r r s s p r s r r p p p s p p r s s r s p p p r r p s r p s r r r r s s s p s s p p r p s s p p r p r r s s p s r r p r r s s p s r r r p p s p r s s r p r r s s p s s r p s s r s s r p p s r p r s r r s s r r p s r s p r r s r s s p s p p p p r s r r s r r r r r s s p s p p r p p p p s r p r r r p s p p 
26vfhar4vmat0f4j32lqefhlfnwc333b	p s p s s s s r r r s s s s s r p s 	r r p p s s p p r s r r r s p s p p 
29fe9qd52oyq3o43uuv2fi2gv0g3v2f9	p r s p r p s p r p p s p p p p r p r s s r p s s r r p p p r r p s p s p s p s p r r s s p r s s r s p s s p p p r p r r s s p r s s s p p s r r p r p r s p r s s p r s p r s p r s p r s p r s p r s p r s p r s p r s p r s p r s r s p r s p r s p r s p r s p r s p r s p r s p r r p s r p s p p r p 	s p r p p p p s s p r p p p s p s p p p p p s p s s s r p p p p p s s r p r r s r p p r p s s p p p p p p p r r r p s s s s r p p s r s p p s s s r r p p r p s r r s s p s p p p r p p r p p s s s s r s s r r s p p r p p r p p r s p s s r p p p p s s s p p r s r r s p r p p r s p r s r s p s r p p r 
3chm0fuot56bg4fk0b5hdi9p22bxq9mw	p p p p p p p p p p p p p p p p p p p p p p p p p p p p p p p p p p p p p p p p p p p p p p p p p p p p p p p p p p p p p p p p p p p p p p p p p p p p p p p p p p p p p p p p p p p p p p p p p p p p p p p p p p p p p p p p p p p p p p p p p p p p p p p p p p p p p p p p p p p p p p p p p p p p p p p p p p p p p p p p p p p p p p p p p p p p p p p p p p p p p p p p p p p p p p p p p p p p p p p p p p p p p p p p p p p p p p p p p p p p p p p p p p p p p p p p p p p p p p p p p p p p p p p p p p p p p p p p p p p p p p p p p p p p p p p p p p p p p p p p p p p p p p p p p p p p p p p p p p p p p p p p p p p p p 	s r s s s p r p s r s p r r s p s p s p r s p r r p p s r s p r s s r p s s r r p s s s p s p p s p r s s s s p s p r s s r r s s r r p r s s r s s p r p p r p r p r p p s s p s s p s s s p r s r p s s p s r p s r r r s p s p r p r r s p p p r r r p p s s r s r p r p p r p p s p s s p r p r r p s r s p p s r s s r r p p p s r s p r p s s s s p s s s s p p p s r s s s s r s p p s s r p p r r r s p p p p s p s r r p p s p p r r s r p s r p p p r p s p s p s r p p p r r s r r r r s p s r r s r r r r p r s r p p r s r p p p p p r p p r p r s r r p r r p r s r p p p r s s p r s r r p s s r p p r s s s p r p p r p s 
3p6xvf2500uoseogvejoxvs3lpj305rm	p p p p p p p p p p p p p p p p p p p p p p p p p p p p p p p p p p p p p p p p p p p p p p p p p p p p p p p p p p p p p p p p p p p p p p p p p p s s s s s s s s s s s s s s s s s s s p p p p p p p p r r r r r r r r r r r r s r s r p s r p s r s r p p r p r p s r p r p s r r p s r s r p s r p s r r 	s p p s p s p s r s r s p r s r s r p s p p p r p r s s s s r s s p r r s p p p r p r p p s s p s s p r r r r r p s p s s s r s s p s p r s s s s p p r r p p p s p s r r s s s s s s p p s s r s s r s r s p p r s s p p p s p s s p p s r s s p p p s s r r s p s p p r r s r p s p r r s p s p p s s p p r 
43j9x5ovujvyj7mjxirg7epjtcmqu1qy	p p p p p p p p p p p p p p p p p p p p p p p p p p p p p p p p p p p p p p p p p 	r s p r p p r p s p s r p r r p p p s s r s s r r s s p p p p s s r s r r r r s p 
4i7mz1ndsvq3qfsxuzpb5v6wgq4dnahl	s s r p s r p s p r s p r p p r p s r p s r p s s p r r s r r s p p 	s p p s r p r s r r s s p r s p s p s r s r r r p p p p s r s p r p 
5teheh1nnyvcwdm6zzm1uf10i6i9g3zc	s r p s r p s r p s r p s r p s r p s p s r p s r p s r p s r p s r p s r p r s p r p r p s s s s s s s s s s p r s r p s s s s s s r s r p s r p s r p r p s r p p r s r s r s p s r p r p p p p p p p p p p p p p p p p p p s r p s s s r p r p r s p r p r s p s s p r s r p s p p r s r p s r s p r s p r s s s s s s s p r p r s p r p s r p s r p s r p s r p s r p s r p s r s r p p r s s r p r p s p p r r r p s p s p s r p r s r p r s r p s r p r s r s r p r s r p p s r p r p s p s r p r r p p p r r p s p p r r r r p r r p p p r r p p s s p r s p s p r s p s r r s s p r p s r r p s r p s p r r s s s r r s p s r p s r r p p r r s s p s p s p r s p p s p s r p r s r p p r s r p s s r r p p s r s s r r r s s r r p r r s r s r s r r r r r s s r s s r r p s s r p r s r p p r s r p r p s p p r r r r p s p s p s r p r s s r p p s r s p s r r p s s p s r r p r p r s p r p s r p s r r r r r p s s p r s p s r p p s p r p s s r p r s r p p r s r p r p s p p r r p s p s p s r p r s s r r p s r s p s r p s s p s r r p r p r s p r p p s r r r r p s s p r s p s r p p s p r p s s r p r s p p r s r p r p s p p r r r r p s p s p s p r s s r r p p s r s p s r r p r p s r r r r s p s s r p r s r p p r s r p r p s p p r r r r p s p s p s r p r s s r r p p s r s p s r r p s s p s r r p r p r s p r p s r p s r r r r r p s s p r s p s r p p s p r p s r r r p s r p r r r p p s p p p s r p r s r p p r s r p r p s p p r s r r s r p p r s r p r p s p p r r r r p s p p s r p r s s r r p p s r s p p s r r p r s p p s r s p r r p r p r s p r p s r p s r r r r r p p s s s s p s s r p p s p r p s r r r p s r p r r r p s p p p s s r p r s r p p r s r p r p s p p r r r r p p p r p p s r p r s s r r p p s r s p s r p s s p s r r p r p r s s r p s r s p r s r p p r s r p r p s s s p s s r s s r s s r s s p s s s s s r p r r r s r p r s s r r p p s r s p s r r p s s p s r r p r p r s p r p s r p s r r r r r p s s p r s p s r p p s p r p s r r r p s r p r r p p s p p p s s r p r s r p p r s r p r p s p p r r r r p s p s p s r p r s s r r p p s r s p s r r p s s p s r r p r p r s p r r r r s r r p s p r s r p s r p s r p s r r p p r s r p r p s s s s s s p p r s r s s r r s r p r s r p p r s r p r p s p p r r r r p s r r s s r r r r p s r p r s s r r p p s r s p s r r p s s p s r r p r p r s p r p s r p s r r r r r p s s p r s p s r p p s p r p s r r r p s r p r r r p p s p p p s s r p r s r p p r s r p r p s p p r r r r p s p s p s r p r s s r r p p s r s p s r r p s s p s r r p r p r s p r s r p s r r r r r p s p r s p s r p p s p r p s r r r p s r p r r r p p s p p s s r p r s r p p r s r p r p s p p r r r r p s p s p s r p r s s r r p p s r s p s r r p s s p s r r p r p r s p r p s r p s r r r r p s s p r s p s r p p s p r p s r r r p s r p r r r p p s p p p s r p r s r p p r s r p r p s p p r r r r p s p s p s r p r s r r p p s r s p s r r p s s p s r r p r p r p p s r p s r r r r r p s s p r s p s r p p s r p s r r r p s r p r r r p p s p p p s s p r s r p p r s r p r p s p p r r r r p s p p s r p r s s r r p p s r s p s r r p s s p r r p r p r s p r p s r p s r r r r r p s s p s p s r p p s p r p s r r r p s r p r r r p s p p p s s r p r s r p p r s r p r p s p p r p s r p r s s r r p p s r s s r p s s p s r r p r p r s p r p s r p s r r r r r p s s p r s p s r p p s p r p s r r r p r p r r r p p s p p p s s r p r s r p p r s r r p s p p r r r r p s p s p s r p r s s r r p p s r s p s r r p s s p s r r p r p r s p r p r p s r r r r r p s s p r s p s r p p s p r p s r r r p s r p r r r p p s p p p s s r p r s r p p r s r p r p s p p r r r r p s p s p s r r s r r p p s r s p s r r p s s p s r r p p s p r p s r p s r r r r p s s p r s p r p p s p r p s r r r p r p p s p r s r s p s p r r s s p r s p s r s r p s p r s s p r r r s p r s r p p r r r r s s s s s s r p s r p p r s r p r p s p p r r s p s p s s s r p s p r r s r r s r r p s s r s r r s s r p s s r s p s p s s s r p s p r r s r p r s p r r p s s s s r p s r p s s r s p s p s s s r p s p r r s p r p r r p s s s p r p s r p s s r s p s p s s r p s p r s p r s p r p s s s p r p r p s s r s p s p s s p p s p r p s p p r r s p s p s s r s p p p p r s s s p r p r s s p s s r p s p r r s r p r s p s p s s s r p s p r r s r p r s p r p s s s s p r p s r p s s r s p s p s s r s p r r s r p r s p r r p s s s s p r p s r p s r s p s p s s s r p s p r r s r p r p r r s s s s p r p s r p s s r s p s p s s r p s p r r s r r s p r r p s s s s p r s r p s s r s p s p s s s r p p r r r p r s p r r p s s s p r p s r s s r s p s s r p s p s r p r s p r p s s p r p s r s s s p p s s r p p r s r p r s p r p s s p r p 	r s p s r r r s r r r s r p r s p r s p s r r s s s s p r p r s s p s p s r r r r r r s s s p r s p s r p r s p s r p s p p s p s p s s r s p r s s p s p s r r p r p p r p p r s s r r s s r r p r p r r s s r r s r p s r s p s r r p p s p r s r s p p p p r r s r r r s r s s s s s p r s r s r p p p r s p p s s r r s s s s r s r p r s s s p s s r r r p p s r s s p s s p p r r p p s r s s p p s s s s p p r r p r p r p p p r r s p r r s p s p r s r s r s r r r s r r p s s p r r p s p p p p s p p r r p r p s r r s p r r p s p s r s s p s r p r s s p s s r s s r r s p r s s s r s r r s s r s s r p s p p p p s r s s s r p r p s r s p s s r s p s s r s s r r p s p p r p r r p p s r s r r s r r r r r r r p r p r s s r r r r r r r s p p r r s s p p r p s s r r p r p r p r s s r r p p p r p r s s s p s r p s s s r p p s r r s s p s s r s s s s r r p p p s r p s s r r r p s p r s s s p s r p s r p p p p s p s s s s r s s s s p p s p p p s p r p p r r s s r r s r r p r r p p p s s s r p p r r p r p p r r s s r r r r r s s p p s r s r s p r s s s r r p p p p r p r p s s p s p s p r r p s s s r p p s s s p r r r p s r r p r s s p s r p r r r s p s r p p r s s s s s s p r r r r p r r p p r s p r r s s s p p r p p r s s p s p s r s s p p p p r p p r r p p p s s r r s s s s s r r s s p p s p r p r r s s s r r r s r r r r r s r s p s r s s r p s r p r s s s p p r s r s p p s p p p s p s p s r s r p p r p p r r p s p p p s s p p s r s p r r r s s p p r s p r p r p s p s p s s p s p s p s s s p r r p r r s p p p r s p s p r r r s s s r r p p p s p s p s r s p p s r s p p s p p r p p p s r s r s p s r s r p p r s s s p s p p r r r r r s p p s p s r r p s s s r s r p s s s p r p p p s r s r s r s p p p s r r s p s p s s r r r s p s r p r p s r p s r r p p r s s s p r s p p r r p p p r p s r r r r p p s r r p p s r r p r r r p s s r p p r r r p s p r s p r r r p s p s s p s r s s s p p s p r p p r p p r p r p s p s r r s s s p s r p r r p r p p p r p r s s s p s r s r p p p p s p s r s r p s r p p r s p r r p r s r r r r r p r r p p s r s s p s r r p s s s r r r r s r s p r r p r r p p s r r p s s r s r s p r r s s s s r s r r s p r p s s r p p r s r s p r r s s r s s s r r r s s r p p p r r p s p p p s r s r p s r r r p s s r s s r s s s r r r p p r r p s p r p p r p p r s r r p s p r s p s s s p s r s r p p s r p r r r r p p p p r r p r s p r r p r s p r s s p r p s p s r p p r s s p s r s p p r s p p p r p s r p r r p r r r s s s r r s s p p s r s p r s p s s s p s r r p p p p p r p s r p p r r s r s r r p p s s p r p r s p r s s r s r r s p s r p r p s s s r p r r s p p r s p r s r p s p s s r r s r p p s s p p s r s p r p s r r s p r r s p s r r r s r s s p r p p s s p r p s s r r s r p r p p s p s r s r s p p p r s r p r r p s s r r p s r r s p p p s p p r p r r r p s p r p p s p s p r p r s p r s p s p s s p p p s r p p p r p p s p p r s s s s r r r s s s s r r s r s r r r r r s r r r p s s p s p r r r s p s r p r p s p p p s r p r r s p p r p r s s p p s p s r r s r s s p r r p r r r p s s r p s s p r r p p r s p s s p s r p p r s p s r p r r p r p r p r s r s p p r p p r r p s s p s p p s p r s p r s r p s p p s s s s r r r s r r r s r s r s p s s p p p p s r p s p s p p p p p r s p r r s s s r s s s s s p s p r s p r r r r p r s s s r p s p p p s p r r s p p s r r r p s r r s s r s s p r p s s p p r r r s s r r r s r r r p s p s r r r s p r r r r r p p p s s r p s s s s s r p s p r s p r s r p r r p s p r p r r p s r r r s r s s r p s r p r s p p s p s s p p r r p r s p p r r s s p r r r s s p p s p s r p s s r r s s s r s p r s p p r p s p s s p p s p s s p s r p r s s p s p r s s s p s p r r p p s r s p s p r r r s r s p s r p p r r r s p r r p p r s s s s p s s s r p r r r r r s s p r s r s p p s s r s r r r s s r p r p s p s p r s s p r p s p r s s s p s s p s r r s r s p r p r p s p s s p p s p p s s p s r r s r s r r s p r r r p p s p s r p p r s s r p s p r s r p r s p r p r p s p s s r s p r p r p r r r r s s s s r p p s p r r r s r p s p r s p s p s p r r r s s r s s p p s r s s r p p r p r p r r r s p s p p p s s r r r p s s p r s p s r s p s p r p s r r p r p p s r r r r p p r r p p p r s p p s r r s r p p s s r s p r r p p s r r s p p s r p s p s s r s s p r s r r r r s p r r r s p p r r p s s r p r r p s s p p s s r p p p r p r p s p p p r p r p p p p r s p r p r r r s s p s r r s r p p s p r s s s p s s r r s s r r r r r s p s s r s p s s p r r p r p s r s s s s s s s s r r s p s p p r s p s p s s p s p s p s p p r p r r s p p s r r r r r s r p s s p r p r r r s r s r s s r s s p s s p s p r p p r p s s r s r s r s p 
7efw55hja6xuzbsezzd67uh1fe2hidmr	s p r p s r p s r p s r p s p r s p s p s p s p s s r p p r r r r r r r s s p p p r r s s r r s s p p p p p s s p s 	r p r s p s r p p s s r r r r p r r p r s p p s s p s s s r p r r r r r p p p r r s s s r r s p p r p p r s p r s s 
7lac8l941l42yzbb4lscznyymtjrqvyh	r s p r s r p s p s 	s s p p p s s p p r 
a5j8vhch2ly14rkjjbhuc5mb96wml9mu	s s p s s s s s s s s s s s s s s s s s s s p p p s s s s s s s s s s s s s s s s s s s r r r p p p 	p p p s p s s p p s s p p p p s r s r s r s r s p s p p r r s p s r p s s p r r s s s s s r r s p p 
anu2y09of0uy8pw2lj20dzo5ypblhhfp	p r p s p r s r p s r p s s r p 	r s r p r r p r p r p r s r p r 
dgvljxl6sui1vitmvjze8xs9z5kgm8v2	s p r r p s s r s s s s s s p s p p s s p s s p r r s s s p p p p p r r s r r r p p p s s s p p r p s r s s p s r p r s s r r p p s r s p p s r p r r s p s p s p p r s s p p r r s r r p s r p r 	r s r s s p r p p r r r p s s s r s s r p r p r r p p r p s r s p r s r s r r r r p s s s s r p p r p r p s p s s r r p s r p p p p r s s s p s s r p s p p s r p r p s r p r p s p s r p p s p s 
dhjjcf95igrrf9gtzcl8u9l0schw1o7u	p 	r 
ecvht9g0i7yqf9xn9azq1o9e2gv4twiq	p r p s r s r p r s p r p s p r p s p r s r p r p s p p s p r p r s p s p r p s p r p s p r p r s p r p s p s r r p r s r p r p r s p p s p r p r s p r p s r r p r s p r p r p s r r p s r p r s p p p r s p r p r s p r s p r s r s p r p s r p r p s p r p s r p r s p s s s r s p p r p r p s r p p r s 	r r r p r s s r p s s s s p r s p s s s p p r r p r s p s s p s r r p s s s s s s r s p s s r p s s s p p p p p p p s s s s p s s r s s p s s p r r p p p r r r p s r s p r p s r r p s r r s r p p r p r r r s p r s r s p r r s r s p s r p s s s p r s p r p p s s r s s s p r s r p s r p r p s p r r p 
emk12pnlsf060oz3ht3q97fpbcs2hzn6	p s s s s s s s s s s s s s s s s s r p r p s p s r r s s p p p r s p r 	p p r p r r r r r p p r s s r r p s p r s p s s r p p r r r r s r s s p 
grok8pqab4ci7k16fad1pjt4pihbwovc	r s r r p p p s s s r s p r r s r p p p r p s s s p r s p s s p r r s r s p p s r s p p p r s r s s p r r p p s s r s r r p p s s r r p s r p p r s r p s r r p p s s r r p r s r p r s s r p r r s s r p s r r p r r s p s s r r s r r p p p s r s r p p p p p p p p p p p r r r r r p p p p p s s s s p r r r r s s s r s r r s s p p r s s s p p p r s s s s s r r p r s s p r p r r s p p p r s r p s r r s p s s s r r r r p s s p p r p p s s r r s p p p p p p p s s p p r r p r p p s s r p r r p p p 	s p p r s r r r p r p s p r r r s p r r s r r p r p r s s s r p r r s s s s p r p r p p s r p s p s p s s p r p r p r s p s s s s r p r p p s s s r s p p r s s s s r r p s s p s r p p s r s p p p p p s p p p p s r p p s r s s r s p r p s p s s r p r r r r r r r p r s r s p r p r s r s r p p p r s p s s p r s r r r s p p r p s r s p r p r s r p p r r r r p s r s r p r s p r p r s s s r s p s s p s r r p s s s r p r p r s r p r s p r r s p p p r r s p s p s p p p s s r p r p r p s r p p r r 
hp0m8zjqqqqj2fjpnbn3vqzlm7uxjs4t	s s s s s s r p 	p p r s s r r p 
icohi7fnxoxnr2mjcfnpt31dfs1xauwf	s p r s p p p p s p s p r p r r p s p r p s r s p p s s p r p s r s p r r r p s s r p r s p r r s s p s r 	s r r r p s p s s r s r s s p p r s p r s p r r p s s s r s s p r r p p p s s p r p r r p p s s p s p p p 
iwf0xkn4vkiek7jdnhfx3lp7g4rnfafk	p p p p s r p s r p s r p s s r p s r s p s p s r p s r p p p s s s r p s r p 	s r p p p p s s p r p p r p r s p p s s r s p p s p p r r s s s r r p p p s p 
jvq10k2mfo32pecefnpvojx78plmjsoy	s p r p s p p r r r p p s r s p s r p p r 	s r p r s r p p p p s r s s p r r p s r r 
k4ie2vnikeil6wywscaabsvs8m7un7yg	s p r s p p s p s r p s r p s p r s p s r s p s r s s r p s s s p r s p r s p r p s s p r r p s r p p s r s r p s 	p p p s r r r p r p p p p p s p r r p r r p r r s r p r r s r s p p p p s s s s r r r s r p p s r s p p r p s r s 
l55niauwze2r430716jgv1f4pusgub1o	r p s r r r r r r p s s s r p r s r p p s r r p r s p p p r s s s s s s s 	r s r s s p p s p s r s r s s r p p p p s s r p r r r r s p s r p r p s p 
lddk7ba3fygp3kjfwa83zp3qfy1xmaq4	r p s r r r r s p p r s s s s r p s r r r r s p s s s s r p s r r r r s p r s s s s r p s r r r r s p r s s s s r p s r r r r s p r s s s s r p s r r r r s p r s s s s p p p p p p p p p p p p p p p p p p p p p p p p p p p p p p p p p p p p p p p p p p p p p p p p p p p p p p p p p p p p p p p p p p p p p p p p p p p p p p p p p p p p p p p p p p p p p p p p p p p p p p p p p p p p p p p p p p p p p p p 	p p p p p r p s s p r r s s r p s s s p r r r p s r s r s r p s r p r p p r s p p s p p r s s p p r p r r r r s r p p r r p p r p r r s s p p r p s p s s r p p p s p s s r r p r p r p r r s s s s r p p s s r p p p s r r s s p p s p r r s r p r p p s p p p p s p s p p s p s r r r p r p s r r s s r s p p s p r s r s r p p p s p p s s s p s s s r s p p r p s p r r p p r p r p p p r r p r p r p p p s s r r 
nkwn0qum22vk61pb5rcevkzri0ns1rhv	p p p p p s s s s r r p s s p p r r r s s s p r s s p s r r p s s r p s p s p p p r s p p p p s s r p s s r p s r p r s p r s s r p p s s s s 	s p r s s r r s s p r s p s r r s s p s r p p p r s p s p s r p r s p s s r s s p p s s p r p s r r p p r s r p p p p s s s p s p s r p p r r 
scf45rww5qqbeuqobry58fk0rbo5yy92	p r s p r s r p p p p s r s p r p p s p r p s p p p s r r r r r r p s s p r p p p p p p p p s s r s p p p p s s s s s s s s r r r p p p s s s r r p p p p p s s s r r r p p p s s s r r p p p p r r r r s s p r s p r s p r s p r s p r s p r s p r s p r p s r p s r p s r p s r p s r p s r p s r p s r p s s r p p p s s p r p r p p r s s s s s r r r r r r r r r p r p 	r s p p r r p p s r p s s r s s p s s s p r s p s r r p s p s s p p s p r r p p p p r p p p p p p p p p p p p p p p p p s s s s r r r p p p s s s r r p p p p p s s s r r r p p s s s r r p p p p r r r r s s p r s p r s p r s p r s p r s p r s p r s p r p s r p s r p s r p s r p s p p s p p s p p s p p s s p p p p s s p p p p p p p r r r r r s s s s s s s s p s s 
t5vuzl5vzf6v1t72ogzb5iafcoacnedj	p p p r s 	s p s p s 
u2cbzrc840ymcry9snrycqtfo74u9zri	p s r p s r p s r p r p s r p s r p p s r p s r p s r p s r p s r p s r p s r p s r p s r p s r p r s p r s p r s p s r p s r p s 	s p r p p s r p r s p p p r s r s r s s r r p r r r r p r s p p s s r p r p r s r p r s r s r r p p s r p r r r p r r s s s p p p 
u2n41uakygxv1l5k1gsnun5u75yv5nl2	p s r r r r r r r r r p p p p p p p p r s s s s s s s s s s s s p p p 	p s p r p s p s r p p r r s s r p p p p r p r r s p s p p s r p p r p 
u6idklfby4rajopallyzsuymi9t74vsj	p s r p p p p s p s p s p r p s s s r r p s r p r s r p p p p s r p s s p s p p s p s s r s 	p s r s p s p s s s s r s r r r s s p s s p r p s p s p p r p p p r p r s s r p s r p p p p 
uj6ahx6u49flyvwsst3fhn1aobkdodg4	r s p r r p r r r s p s r p r s p r s p r r p r r r s r s r s r p p r s r p r r s r s r s 	s r p p s p p p r p p r s s p r p p s s s p s r p r s r s p r s s s s r r s p r s s p s p 
vazeu1ri1sdziin6h3m1wpfglsg5nwiz	s s s s s p r p s r p s r p s r p s r p s r p s r p s r p s s p p r p s r p s r p p s r p r p r r r s p r s s s s s s s s s s s s s s s s s s s r p r s p r s p r s p 	p r s s s p s r p s r r s r p s s s p s s s p r p r s p s p s p p r s s p p r s r r p s p r s r s s p p s p p p s r p s r s p s r p r s r r r s s r p p p p p s r p p 
vln34pt042ekc7p8692bfcogh30pakhi	p p p p p r s p r r p s s p r p p r s p r s p r r r s 	s s s r s p r s r p p p r p s p r s s s s r r s s p s 
wrn2lkag0tshocautnye3tslvyv95vee	r p s r p s p p r p p r p s r p r p s p r s p r s p r p r p p r s p p r r p s p r p p p p r s 	s r r r s s r r r r p s p p s r r s r p r p s p s s r p r s r r p p p p p p r r r r r s s p s 
yhiyb6lyb59f3c7lkjp1z7quejh0gmpm	s r p r s p r p s p r s p p s p s r p r s r s p p s p r r r r p r r p s s s p p p p s p p p r r r s p s r r p p p p r p r r r p r p r p r p r r p r p r p r p r p r r s p s p p s s r s p p s p p p p p p p r p 	r s s r s p r r p s s p r p s r r r p r s s p r s r s r p p s s s r p r s s r p s r r s p p r p r p s p p s p r s p s r s r r s p r s r r s r r p r p p r p s r s p s p s r p r s s p r s r s s p p s r p p s s 
ym6zpewn7aowb1kcb35s5sadtopia7um	s s s s s s s s s s s s s s s s s s s s s s s s s s s s s s s s s s s s s s s s s s s s s s s s s s 	p r p p p p r s s s p s r p s r s r p p p s r s r p p s r s p p p r r p s r s s s s p r s r p p p s 
